33333333333333333333333333333333333333333333333333333333333333333333333333333333333333333333333333333333333333333333333333
33333333333333333333333333333333333333333333333333333333333333333333333333333333333333333333333333333333333333333333333333
33333333333333333333333333333333333333333333333333333333333333333333333333333333333333333333333333333333333333333333333333
33333333333333333333333333333333333333333333333333333333333333333333333333333333333333333333333333333333333333333333333333
33333333333333333333333333333333333333333333333333333333333333333333333333333333333333333333333333333333333333333333333333
33333333333333333333333333333333333333333333333333333333333333333333333333333333333333333333333333333333333333333333333333
33333333333333333333333333333333333333333333333333333333333333333333222222222222222222222222222222222222222333333333333333
33333333333333333333322222222222222222222333333333333333333333333333211111111111111444444441111111111111112333333333333333
33333333333333333333321111111111111111112333333333333333333333333333211111111111111444444441111111111111112333333333333333
33333333333333333333321111111111111111112333333333333333333333333333211111111111111444444441111111111111112333333333333333
33333333333333333333321111111111111111112333333333333333333333333333211111111111111444444441111111111111112333333333333333
33333333333333333333321111111111111111112333333333333333333333333333211111111111111111111111111111111111112333333333333333
33333333333333333333321111111111111111112333333333333333333333333333211111111111111111111111111111111111112333333333333333
33333333333333333333321111111111111111112333333333333333333333333333211111111111111111111111111111111111112333333333333333
33333333333333333333321111111111111111112333333333333333333333333333211111111111111111111111111111111111112333333333333333
33333333333333333333321111111111111111112333333333333333333333333333211111111111111111111111111111111111112333333333333333
33333333333333333333321111111111111111112333333333333333333333333333211111111111111111111111111111111111112333333333333333
33333333333333333333321111111111111111112333333333333333333333333333211111111111111111111111111111111111112333333333333333
33333333333333333333321111111111111111112333333333333333333333333333211111111111111111111111111111111111112333333333333333
33333333333333333333321111111111111111112333333333333333333333333333211111111111111111111111111111111111112333333333333333
33333333333333333333321111111111111111112333333333333333333333333333211111111111111111111111111111111111112333333333333333
33333333333333333333321111111111111111112333333333333333333333333333211111111111111111111111111111111111112333333333333333
33333333333333333333321111111111111111112333333333333333333333333333211111111111111111111111111111111111112333333333333333
33333333333333333333321111111111111111112333333333333333333333333333211111111111111111111111111111111111112333333333333333
33333333333333333333321111111111111111112333333333333333333333333333211111111111111111111111111111111111112333333333333333
33333333333333333333321111111111111111112333333333333333333333333333211111111111111111111111111111111111112333333333333333
33333333333333333333322222222222222222222333333333333333333333333333211111111111111555555551111111111111112333333333333333
33333333333333333333333333333333333333333333333333333333333333333333211111111111111555555551111111111111112333333333333333
33333333333333333333333333333333333333333333333333333333333333333333211111111111111555555551111111111111112333333333333333
33333333333333333333333333333333333333333333333333333333333333333333211111111111111555555551111111111111112333333333333333
33333333333333333333333333333333333333333333333333333333333333333333222222222222222222222222222222222222222333333333333333
33333333333333333333333333333333333333333333333333333333333333333333333333333333333333333333333333333333333333333333333333
33333333333333333333333333333333333333333333333333333333333333333333333333333333333333333333333333333333333333333333333333
33333333333333333333333333333333333333333333333333333333333333333333333333333333333333333333333333333333333333333333333333
33333333333333333333333333333333333333333333333333333333333333333333333333333333333333333333333333333333333333333333333333