22222222222222222222
21111111111111111112
21111111111111111112
21111111111111111112
21111111111111111112
21111111111111111112
21111111111111111112
21111111111111111112
23331111111111113332
23333111111111133332
23333311111111333332
23333331111113333332
23333333111133333332
23333333111133333332
23333333111133333332
23333333111133333332
23333333111133333332
23333333111133333332
23333333111133333332
22222222222222222222