11111111111111111111111111111
11111111111111111111111111111
11111111111111111111111111111
11111111111111111111111111111
11111111111111111111111111111
11111111111111111111111111111
11111111111111111111111111111
11111111111111111311111111111
11111311111111111111111131111
11111111111111111111111111111
11111111111222222211111111111
11111111112222222221111111113
11111111112222222221111111111
11311111112222222221111111111
11111111112222222221111111111
11111111112222222221111111111
11111111112222222221111111111
11111131112222222221111113111
11111111112222222221111111111
11111111111222222211111111111
11111111111111111111111111111
11111111111111111111113111111
11113111111111113111111111111
11111111111111111111111111111
11111111111111111111111111111
11111111311111111111111111111
11111111111111111111113111111
11111111111111111111111111111
11111111111111131111111111111
11111311111111111111111111111